+---------/Back\---------+
|                        |
|         MAGENTA        |
|                        |
+----\1/----------\2/----+
